#########
#       #
#  #    #
# #$#   #
#  #    #
#      @#
#       #
# .#    #
#########