############
#    .  # .#
# ## $  #  #
#  # $  #  #
# .   #    #
#  #### #  #
# @    $   #
#          #
############
