#######
#.    ###
###     #
#  #  $ #
#.  # ###
# @ #  #
##  $  #
 # *  ##
 ######  