#########
#       #
#@ $ # .#
#       #
#########