###################
#        $        #
#   #    .    $   #
#   #####     #####
#       .  $      #
#   #   #   #     #
#   #####   ##### #
#     $          .#
#   #   #   #     #
#####   # @ #    .#
###################