 #######
##     ##
#   @   #
#       #
#   $   #
#       #
##   . ##
 ####### 
