 #######
##     ##
#   @   #
#   #   #
#   $   #
#       #
##   . ##
 ####### 
