#########
##     ##
#   @   #
#       #
#   $   #
#       #
##  .  ##
#########
