##############
#            #   
#            #
#    #       #
#    #       #
#    #      .#
#    #########
#            #
#     $      #
#           @#
##############