##############
#@   #.     .#   
#  $ #       #
#    #       #
#    #.      #
#    #       #
#    ######  #
#            #
# $         $#
#            #
##############