  ###########   
 ##  .   .  ## 
##  #######  ##
#  ##  .  ##  #
# ##  # #  ## #
#      $      #
####  $@$  ####
   #########  
