####
#  #########
# $$   #   #
#  ##..  $ #
## # ..##$##
##.# ###@ #
#. .   ## #
# .# $    ##
##$######  #
# $      $ #
#   #####  #
#####   ####
